R 1024 720



NO ./textures/WALL10.xpm



SO  ./textures/WALL65.xpm
WE          ./textures/WALL4.xpm


EA ./textures/WALL21.xpm
S ./textures/barrel.xpm
F 255 ,   122 ,     7
C 0,255,     0






1   1111111111111111111111111
    1000000000110000000000001
11111000000000110000000000001
10000000000000000000000211111111111111
111111111011000001112222222222221    11
10000000001100001110110110111111    11
11110111111111011100000010001         
11110111111111011101010010001
11000000110101011100000010001
10000000000000001100000010001
10000000000W00001100010010001
11000001110101011101101110001
11110111 1110101 101111010001
11111111 1111111 111111111111
